NO textures/test/north.xpm
SO textures/test/south.xpm
WE textures/test/west.xpm
EA textures/test/east.xpm

F 20,20,20
C 200,200,200

11111
10001
10001
1S001
10001
10001
11001
10001
10001111
10001
10001
10001
11111
1
1




11111999
10001999
10001999
13001999
10001999
10001999
11001999
10001999
10001111
10001999
10001999
10001999
11111999
19999999
99999999
good map