NO ./test_maps/textures/wall.xpm
SO ./test_maps/textures/wall.xpm
WE ./test_maps/textures/wall.xpm
EA ./test_maps/textures/wall.xpm


C 171, 154, 58
F 127, 90, 22

111111111111111111111111111111111111111111111111111111111111111111111111111111111111111111111111111111111111111111111111111111111111111111111111111111111111111111111111111111111111111111
10000001111111111111111111111111111111111111111111111111111111111111111111111111111111111111111111111111111111111111111111111111111111111111111111111111111111111111111111111111111111111
110000000000000000000000001100000000000000000000000000000000000000000000001100000000001100001100000000001100001100000000000000001100000000001100001100000000000000000000000000001100001111
111111111111111111111100001111111111111111111111111111111111111100001100001111111100001100001100001100001100001100001100001111111100001111111100001111111111111111111111111100001100001111
111100000000000000000000001100000000001100000000000000001100000000001100000000000000000000001100001100000000000000001100000000001100000000000000000000000000001100000000000000000000001111
111100001111111100001100001100001111111100001100001111111111111111111111111111111111111100001111111100001100001111111111111111111100001111111111111100001111111100001111111111111100001111
111100001100000000001100000000000000000000001100001100001100001100001100000000001100001100000000001100001100000000000000000000000000001100000000001100000000000000000000001100000000001111
111111111100001100001111111111111100001111111111111100001100001100001100001100001100001100001111111100001111111100001111111100001100001100001100001111111111111111111111111100001100001111
111100000000001100001100000000000000000000001100001100000000000000000000001100001100000000000000001100001100000000001100001100001100001100001100001100000000000000000000001100001100001111
111100001100001111111111111111111100001111111100001111111111111100001111111100001100001100001111111111111111111111111100001100001100001111111100001111111111111100001100001100001111111111
111100001100001100000000000000000000001100000000000000001100000000001100001100001100001100000000000000001100001100001100001100001100001100001100001100000000000000001100001100001100001111
111100001111111111111111111111111100001111111100001111111100001111111100001111111100001111111100001111111100001100001100001111111100001100001100001111111111111100001100001111111100001111
111100001100001100000000000000000000000000001100000000000000000000000000000000001100000000001100001100001100000000001100001100001100000000000000001100000000000000001100001100000000001111
111100001100001100001111111111111100001100001111111111111111111111111100001111111111111100001111111100001100001111111100001100001111111100001100001100001100001111111100001111111100001111
111100000000001100000000000000001100001100000000000000001100001100000000001100001100001100000000001100000000000000001100001100000000000000001100001100001100000000001100001100000000001111
111100001111111111111111111100001111111100001100001111111100001111111100001100001100001111111100001100001111111111111100001100001111111111111100001100001100001111111111111111111100001111
111100001100001100000000000000001100000000001100001100001100001100000000001100000000000000001100000000001100000000001100001100001100000000001100001100001100001100000000000000000000001111
111100001100001100001111111100001111111111111100001100001100001100001111111111111100001100001100001111111100001100001100001111111100001111111100001111111100001111111100001111111100001111
111100000000001100001100001100001100001100000000001100000000001100000000000000001100001100000000000000001100001100000000000000000000000000000000000000000000001100000000000000001100001111
111100001111111100001100001111111100001100001100001100001100001100001100001111111111111111111100001100001111111111111111111111111100001111111100001111111100001100001100001111111100001111
111100000000001100001100000000001100001100001100000000001100000000001100000000001100001100001100001100000000000000001100001100000000001100000000001100000000000000001100000000001100001111
111100001111111111111100001111111100001111111100001100001111111100001100001111111100001100001100001111111111111111111100001111111111111111111100001111111100001111111100001111111111111111
111100001100000000000000001100000000000000000000001100001100000000001100000000000000000000000000000000000000000000001100000000000000000000001100000000001100001100000000001100001100001111
111100001100001100001111111111111100001111111100001111111111111111111111111111111111111100001111111111111100001100001111111111111111111100001111111100001111111100001100001100001100001111
111100000000001100000000001100000000001100000000001100001100000000001100000000000000001100N0D00001100001100001100000000000000001100000000000000000000001100000000001100000000000000001111
111111111100001111111111111111111111111111111100001100001100001100001100001100001100001100001100001100001111111111111100001111111100001100001100001111111111111100001111111111111100001111
111100000000001100001100001100000000000000000000001100000000001100001100001100001100001100000000000000001100000000001100000000000000001100001100001100000000000000001100000000001100001111
111100001100001100001100001111111100001111111111111111111100001111111111111111111100001111111111111100001111111100001100001100001111111100001111111100001111111100001100001111111100001111
111100001100001100000000000000001100001100001100000000000000000000000000001100000000001100000000000000000000001100001100001100001100001100001100000000001100000000000000000000001100001111
111111111100001111111100001111111111111100001111111100001111111111111111111111111100001111111100001111111100001100001100001100001100001111111111111100001100001100001100001111111100001111
111100001100000000000000000000001100001100000000001100000000001100000000000000000000000000000000001100001100001100000000001100000000000000001100000000001100001100001100001100001100001111
111100001111111100001111111100001100001111111100001111111100001111111111111100001111111100001100001100001111111111111100001111111111111111111100001100001100001111111111111100001111111111
111100000000001100001100000000001100001100000000000000000000001100000000001100000000001100001100000000000000000000001100000000001100001100000000001100001100001100000000000000001100001111
111100001111111100001100001111111100001111111100001111111100001100001111111100001111111111111111111111111111111111111111111111111100001100001100001111111111111111111100001111111100001111
111100000000000000001100000000001100000000000000001100001100000000001100001100000000000000000000000000001100001100001100000000001100000000001100001100000000000000000000001100001100001111
111111111111111100001111111111111100001100001111111100001100001100001100001111111100001111111111111100001100001100001100001111111111111111111100001111111111111100001100001100001100001111
111100000000000000001100000000000000001100000000000000001100001100001100001100000000000000000000001100001100000000000000000000001100001100001100000000000000001100001100000000000000001111
111111111100001111111111111111111100001100001111111111111100001100001100001100001100001100001111111111111100001100001111111100001100001100001100001100001111111111111111111100001100001111
111100001100000000000000001100000000001100001100000000001100001100001100000000001100001100000000000000001100001100001100000000000000001100000000001100000000000000000000001100001100001111
111100001111111100001111111111111111111100001100001111111100001111111111111100001111111100001111111111111100001111111100001111111111111100001111111111111111111111111100001100001100001111
111100000000000000001100000000001100000000001100000000001100000000000000000000001100000000001100000000000000001100001100000000000000001100000000000000001100001100000000000000001100001111
111111111111111100001100001100001111111100001100001111111100001111111111111100001111111100001100001111111100001100001111111100001111111100001100001111111100001100001111111100001111111111
111100000000000000001100001100000000001100001100001100001100001100001100000000000000001100000000001100000000000000001100000000000000001100001100001100000000001100001100000000000000001111
111111111111111100001100001111111100001100001100001100001111111100001111111111111111111111111100001111111111111100001111111100001111111100001100001111111100001111111111111100001111111111
111100000000000000000000001100001100001100000000000000000000001100001100000000001100001100000000000000001100001100001100001100000000001100001100000000000000000000001100000000000000001111
111100001111111100001100001100001111111111111111111100001100001100001111111100001100001100001111111100001100001100001100001111111111111111111100001100001100001111111111111111111111111111
111100000000001100001100001100001100001100000000001100001100000000001100001100000000001100000000001100001100000000000000001100000000000000001100001100001100000000000000001100001100001111
111100001100001111111100001100001100001100001100001100001111111111111100001111111100001100001111111100001100001111111100001100001111111111111111111100001111111100001100001100001100001111
111100001100001100000000000000000000000000001100001100001100000000000000000000000000001100001100001100001100001100000000000000001100001100000000001100001100000000001100000000000000001111
111100001100001111111100001111111100001111111111111111111111111111111100001100001111111100001100001111111111111100001111111111111100001100001111111100001111111111111111111111111100001111
111100001100001100001100000000001100001100000000000000001100001100000000001100000000001100000000001100001100001100001100000000000000000000001100000000001100000000000000000000000000001111
111111111100001100001100001100001100001100001111111100001100001100001100001111111111111100001100001100001100001100001111111111111100001111111100001111111100001111111100001100001111111111
111100000000001100001100001100001100000000001100000000000000000000001100001100000000000000001100001100001100001100000000001100001100001100001100000000001100001100000000001100000000001111
111100001111111100001111111111111111111111111100001100001111111111111111111111111111111100001100001100001100001100001111111100001100001100001111111111111111111100001111111111111111111111
111100000000001100000000000000001100000000000000001100000000000000000000000000001100001100001100001100000000000000000000001100000000000000001100000000001100000000000000000000001100001111
111111111111111111111100001100001100001111111100001100001111111111111111111111111100001111111111111100001100001111111100001111111111111100001100001111111111111100001111111111111100001111
111100000000000000001100001100000000001100000000001100000000001100000000000000000000000000000000001100001100001100000000000000001100001100000000000000001100000000000000000000000000001111
111100001111111111111100001111111111111100001100001111111111111100001111111100001111111111111111111100001111111100001111111111111100001111111100001111111111111111111111111111111100001111
111100000000001100001100000000001100000000001100001100001100001100001100001100000000001100000000000000000000001100000000001100000000001100001100000000001100000000000000001100000000001111
111111111100001100001100001100001111111111111100001100001100001111111100001100001111111100001111111111111100001111111100001111111100001100001111111100001100001111111111111100001111111111
1111000000000000000000000011000000000000000011000011000000000000000000000000000000000000000011000000000000000000000011000011000000000000000000000000000000000000000000000000000000000011
11111111111111111111111111111111111111111111111111111111111111111111111111111111111111111001111111111111111111111111111111111111111111111111111111111111111111111111111111111111111111111
111111111111111111111111111111111111111111111111111111111111111111111111111111111111111111111

